18
XXXXXXXXXXXXXXXXXXX
X...X.............X
X.X.X.XXXXX.XXX.X.X
X.X.....X.......X.X
X.XXX.X.X.XXX.XXX.X
X.....X...X...X...X
X.XXXXX.XXX.XXX.X.X
X.X.........X...X.X
X.X.X.XXXXXXX.X.X.X
X.X.X.....X...X...X
X.X.X.XXX.X.X.XXX.X
X...X...X...X.....X
X.X.X.X.X.X.X.XXX.X
X.X...X...X.....X.X
X.X.XXXXX.X.XXX.X.X
X.X.............X.X
X.XXXXXXXXX.XXXXX.X
X.................X
XXXXXXXXXXXXXXXXXXX
