20
XXXXXXXXXXXXXXXXXXXXX
X...................X
X.XXXXX.X.XXXXX.XXX.X
X.X...X.X.....X.....X
X.X.X.X.X.XXX.XXXXX.X
X...X.X...........X.X
X.X.X.X.XXX.XXXXX.X.X
X.X...X...X.........X
X.XXX.X.X.X.XXX.XXX.X
X.......X.....X...X.X
X.XXXXX.XXXXX.X.X.X.X
X.....X...X...X.X...X
X.XXX.X.X.X.X.X.X.X.X
X.....X.X...X...X.X.X
X.X.XXX.XXXXXXX.X.X.X
X.X.X.....X.....X...X
X.X.X.XXX.X.XXXXX.X.X
X.X.....X...X.....X.X
X.XXXXX.XXX.X.XXX.X.X
X...................X
XXXXXXXXXXXXXXXXXXXXX
