08
XXXXXXXXX
X.......X
X.X.XXX.X
X.X...X.X
X.X...X.X
X.X...X.X
X.X.XXX.X
X.......X
XXXXXXXXX
