06
XXXXXXX
X.....X
X.X...X
X.X...X
X.XXX.X
X.....X
XXXXXXX
