14
XXXXXXXXXXXXXXX
X.....X.....X.X
X...X.X.X.X.X.X
X...X...X.X...X
X.XXX.XXX.XXX.X
X.....X.......X
XXX.XXX.X.XXX.X
X...X...X.....X
X.X.X.XXXXXXX.X
X.X...........X
X.X.XXXXX.XXX.X
X...X...X...X.X
X.XXX.X.X.X.X.X
X.....X...X...X
XXXXXXXXXXXXXXX
