70
XXXXXXXXXXXXXXXXXXXXXXXXXXXXXXXXXXXXXXXXXXXXXXXXXXXXXXXXXXXXXXXXXXXXXXX
X.....................................................................X
X...XXXXXXXXXXXXXXXXXXXXXXXXXXXXXXXXXXXXXXXXXXXXXXXXXXXXXXXXXXXXXXX...X
X.....................................................................X
X.X.XXXXXXXXXXXXXXXXXXXXXXXXXXXXX.....XXXXXXXXXXXXXXXXXXXXXXXXXXXXX.X.X
X.X.X.............................................................X.X.X
X.X.X.............................................................X.X.X 
X.X.X.............................................................X.X.X 
X.X.X.............................................................X.X.X 
X.X.X.............................................................X.X.X 
X.X.X.............................................................X.X.X 
X.X.X.............................................................X.X.X 
X.X.X.............................................................X.X.X 
X.X.X.............................................................X.X.X 
X.X.X.............................................................X.X.X 
X.X.X.............................................................X.X.X 
X.X.X.............................................................X.X.X 
X.X.X.............................................................X.X.X 
X.X.X.............................................................X.X.X 
X.X.X.............................................................X.X.X 
X.X.X.............................................................X.X.X 
X.X.X.............................................................X.X.X 
X.X.X.............................................................X.X.X 
X.X.X.............................................................X.X.X 
X.X.X.............................................................X.X.X 
X.X.X.............................................................X.X.X 
X.X.X.............................................................X.X.X 
X.X.X.............................................................X.X.X 
X.X.X.............................................................X.X.X 
X.X.X.............................................................X.X.X 
X.X.X.............................................................X.X.X 
X.X.X.............................................................X.X.X 
X.X.X.............................................................X.X.X 
X.X.................................................................X.X 
X.X.................................................................X.X 
X.X.................................................................X.X 
X.X.................................................................X.X 
X.X.................................................................X.X 
X.X.X.............................................................X.X.X 
X.X.X.............................................................X.X.X 
X.X.X.............................................................X.X.X 
X.X.X.............................................................X.X.X 
X.X.X.............................................................X.X.X 
X.X.X.............................................................X.X.X 
X.X.X.............................................................X.X.X 
X.X.X.............................................................X.X.X 
X.X.X.............................................................X.X.X 
X.X.X.............................................................X.X.X 
X.X.X.............................................................X.X.X 
X.X.X.............................................................X.X.X 
X.X.X.............................................................X.X.X 
X.X.X.............................................................X.X.X 
X.X.X.............................................................X.X.X 
X.X.X.............................................................X.X.X 
X.X.X.............................................................X.X.X 
X.X.X.............................................................X.X.X 
X.X.X.............................................................X.X.X 
X.X.X.............................................................X.X.X 
X.X.X.............................................................X.X.X 
X.X.X.............................................................X.X.X 
X.X.X.............................................................X.X.X 
X.X.X.............................................................X.X.X 
X.X.X.............................................................X.X.X 
X.X.X.............................................................X.X.X 
X.X.X.............................................................X.X.X 
X.X.X.............................................................X.X.X 
X.X.XXXXXXXXXXXXXXXXXXXXXXXXXXXXX.....XXXXXXXXXXXXXXXXXXXXXXXXXXXXX.X.X
X.....................................................................X
X...XXXXXXXXXXXXXXXXXXXXXXXXXXXXXXXXXXXXXXXXXXXXXXXXXXXXXXXXXXXXXXX...X
X.....................................................................X
XXXXXXXXXXXXXXXXXXXXXXXXXXXXXXXXXXXXXXXXXXXXXXXXXXXXXXXXXXXXXXXXXXXXXXX
