11
XXXXXXXXXXX
X.X.......X
XXX.XXXXX.X
X.X.X.X.X.X
XXX.XXXXX.X
X...X.X.X.X
X.XXXXXXX.X
X.X.X.X.X.X
X.XXXXXXX.X
X.........X
XXXXXXXXXXX
